"filename", "language", "Makefile", "C++", "CSV", "comment", "blank", "total"
"c:\Users\patel\Desktop\Jinay\Robotics\Code\OverUnderCode\include\Autonomous\DriverAuto\DriverAutonomous.h", "C++", 0, 90, 0, 34, 24, 148
"c:\Users\patel\Desktop\Jinay\Robotics\Code\OverUnderCode\include\Autonomous\Odometry\Odometry.h", "C++", 0, 58, 0, 24, 20, 102
"c:\Users\patel\Desktop\Jinay\Robotics\Code\OverUnderCode\include\Autonomous\PID\PID.h", "C++", 0, 25, 0, 10, 6, 41
"c:\Users\patel\Desktop\Jinay\Robotics\Code\OverUnderCode\include\Autonomous\PurePursuit\Path.csv", "CSV", 0, 0, 0, 0, 1, 1
"c:\Users\patel\Desktop\Jinay\Robotics\Code\OverUnderCode\include\Autonomous\PurePursuit\PurePursuit.h", "C++", 0, 9, 0, 0, 2, 11
"c:\Users\patel\Desktop\Jinay\Robotics\Code\OverUnderCode\include\DriverControl\Catapult.h", "C++", 0, 31, 0, 6, 7, 44
"c:\Users\patel\Desktop\Jinay\Robotics\Code\OverUnderCode\include\DriverControl\Intake.h", "C++", 0, 24, 0, 4, 6, 34
"c:\Users\patel\Desktop\Jinay\Robotics\Code\OverUnderCode\include\DriverControl\JoystickControl.h", "C++", 0, 21, 0, 8, 8, 37
"c:\Users\patel\Desktop\Jinay\Robotics\Code\OverUnderCode\include\DriverControl\Wings.h", "C++", 0, 15, 0, 3, 4, 22
"c:\Users\patel\Desktop\Jinay\Robotics\Code\OverUnderCode\include\robot-config.h", "C++", 0, 17, 0, 10, 8, 35
"c:\Users\patel\Desktop\Jinay\Robotics\Code\OverUnderCode\include\vex.h", "C++", 0, 14, 0, 0, 4, 18
"c:\Users\patel\Desktop\Jinay\Robotics\Code\OverUnderCode\makefile", "Makefile", 12, 0, 0, 9, 10, 31
"c:\Users\patel\Desktop\Jinay\Robotics\Code\OverUnderCode\src\main.cpp", "C++", 0, 77, 0, 71, 32, 180
"c:\Users\patel\Desktop\Jinay\Robotics\Code\OverUnderCode\src\robot-config.cpp", "C++", 0, 23, 0, 14, 10, 47
"c:\Users\patel\Desktop\Jinay\Robotics\Code\OverUnderCode\vex\mkenv.mk", "Makefile", 70, 0, 0, 22, 19, 111
"c:\Users\patel\Desktop\Jinay\Robotics\Code\OverUnderCode\vex\mkrules.mk", "Makefile", 19, 0, 0, 7, 7, 33
"Total", "-", 101, 404, 0, 222, 168, 895